111111111111111111
100000000000000001
1000P0000000000001
100000000000000001
1000000E0000000001
100000000000000001
10000C000000000001
100000000000000001
100000000000000001
100000000000000001
100000000000000001
100000000000000001
11X111111111111111
