111111111111111111
100000000000000001
1000P0000C00000011
100000000000100101
1000000X0000011001
100000000000000001
10000C000000000001
1000000000X00C0001
101110000000010001
111000000000010001
1000C0000X00010001
100000000000010001
11E111111111111111
