111111111111111111
100000000000000001
1000P0000C00000011
100000000000100101
1000000X0000011001
100001000000000001
10001C000000000001
1000010000X00C0001
101110000000010001
111000000000010001
1000C0000X00010001
10E000000000010001
111111111111111111