1111111111
1P0C0E1001
10000000X1
1010101001
1111111111